12321221232123212323
12333212321233212233
13231223212213232312
33212132221323121323
13222133122133212331
13222133113131212312
12132313213231213322
22132322131333122213
31323221331333113132
13222132322132312213
13231232312223122312
31323312222131213313
31323123312323213121
21322132233121322131
31223121322213132133
13231331313113213223
13221323213321213131
31232331213231213221
31223121322132312231
31321322131213121312