RVBVRRRVRBVVBRB
BBRRVVRRRVRBVRV
RVRBRVRVBRVVVBB
VVRVVVRBVRRRVVV
BVBRVRVVRVBBRRB
RBVRVRBVRVRRVVR
RRBRVBBRRRRRRRV
RVBVBRBVRRVRVBV
BRBBVVBVRBVRRVR
RBBBBVRBVRBBRRB
